            #####   #####   #####
            #####   #####   #####
 @#########################################@  
 #            #       #       #            #  
 #            #       #       #            #  
 #            #       #       #            #
#######    ####### ####### #######    #######
################## ####### #######    #######
#######    ####### ####### #######    #######
#######    ####### ####### #######    #######
#######    ####### ####### #######    #######
#######    ####### ####### #######    #######
#######    ####### ####### #######    #######
#######    ####### ####### #######    #######
#######    ####### ####### #######    #######
#######    ####### ####### #######    #######
#######    ####### ####### #######    #######
#######    ####### ####### ##################
#######    ####### ####### #######    #######
 #            #       #       #            #  
 #            #       #       #            #  
 #            #       #       #            #  
 @#########################################@  
            #####   #####   #####
            #####   #####   #####