################### ####################
################### ####################
################### ####################
################### ####################
###################################### #
################### #################  #
################### ################  ##
################### ###############  ###
################### ##############  ####
#######                         ## #####
####     ##########@##########     #####
#######  #####################  ########
#   ####################################
#######  #####################  ########
####     ##########@##########     #####
#######                         ## #####
################### ##############  ####
################### ###############  ###
################### ################  ##
################### #################  #
###################################### #
################### ####################
################### ####################
################### ####################
################### ####################
